107
8
0  0   0   0   0   0   0    0   0   0    0  0    0  0     0   0   0    0    0   0  0   0   0    0   0   0   0   0  0   0   0   0   0   0   0   0   0    0    0     0   0    0    0   0    0  0   0    0   0    0     0   0    0    0     0   0    0   0    0    0   0   0    0  0     0  0    0   0   0    0    0   0    0    0    0     0    0   0     0    0     0    0      0      0    0    0      0     0   0    0    0   0    0     0     0     0    0    0   0     0    0   0    0     0    0     0    0   
0  0   0   0   0   0   0    0   0   0    0  0    0  0     0   0   0    0    0   0  0   0   0    0   0   0   0   0  0   0   0   0   0   0   0   0   0    0    0     0   0    0    0   0    0  0   0    0   0    0     0   0    0    0     0   0    0   0    0    0   0   0    0  0     0  0    0   0   0    0    0   0    0    0    0     0    0   0     0    0     0    0      0      0    0    0      0     0   0    0    0   0    0     0     0     0    0    0   0     0    0   0    0     0    0     0    0
0  0   0   0   0   0   0    0   0   0    0  0    0  0     0   0   0    0    0   0  0   0   0    0   0   0   0   0  0   0   0   0   0   0   0   0   0    0    0     0   0    0    0   0    0  0   0    0   0    0     0   0    0    0     0   0    0   0    0    0   0   0    0  0     0  0    0   0   0    0    0   0    0    0    0     0    0   0     0    0     0    0      0      0    0    0      0     0   0    0    0   0    0     0     0     0    0    0   0     0    0   0    0     0    0     0    0
0  0   0   0   0   0   0    0   0   0    0  0    0  0     0   0   0    0    0   0  0   0   0    0   0   0   0   0  0   0   0   0   0   0   0   0   0    0    0     0   0    0    0   0    0  0   0    0   0    0     0   0    0    0     0   0    0   0    0    0   0   0    0  0     0  0    0   0   0    0    0   0    0    0    0     0    0   0     0    0     0    0      0      0    0    0      0     0   0    0    0   0    0     0     0     0    0    0   0     0    0   0    0     0    0     0    0
0  0   0   0   0   0   4    0   0   5    0  0  21  22     0   0   0    0    0   0  0   0   0    0   0   0   0   0  0   0   0   0   0   0   0   0   0    0    0     0   0    0    0   0    0  0   0    0   0    0     0   0    0    0     0   0    0   0    0    0   0   0    0  0     0  0    0   0   0    0    0   0    0    0    0     0    0   0     0    0     0    0      0      0    0    0      0     0   0    0    0   0    0     0     0     0    0    0   0     0    0   0    0     0    0     0    0
0  0   0   0   0   0   3    0   21  21   21 0    0  0     0   0   0    0    0   0  0   0   0    0   0   0   0   0  0   0   0   0   0   0   0   0   0    0    0     0   0    0    0   0    0  0   4    0   0    0     0   0    0    4     0   0    0   0    0    0   0   0    0  0     0  0    0   0   0    0    0   0    0    0    0     0    0   0     0    0     0    0      0      0    0    0      4     0   0    0    0   0    0     4     0     0    0    0   0     0    0   0    0     0    0     0    0
0  0   0   0   0  22   22  22   0   0    0  0    0  0     27   0   0    0    5   0  0  21   21    0   0  25   0   0  0   0   0   0   0   27  0   0   0    0    0    29   0    0    0   0    0  0   3    0   0    0     0   0    0    3     0   0    0   0    0    0   5   0    0  0     0  0   25   0   0    0    0   0    0    27   0     0    0   0     0    0     29   0      0      0    0    0      3     0   0    0    0   0    0     3     0     0    0    0   0     0    5   0    0     0    0     0    25                      
21 22  21  22  21  0   0    0   0   0    0  0    0  0   21  22   21  22   21  22   0  0  0  22  21  22  21  22  21  22  21  22  21  22  21  22  21   22   21   22  21   22   21   22  21  22  21  22   21   22   21   22   21   22   21   22  21  22   21   22  21  22   21  22   21  22  21   22  21   22  21   22   21   22   21   22   21   22   21    22    21   22     21    22    21   22     21   22   21   22   21  22   21    22    21    22   21   22  21   22   21   22   21   22   21    22    21    